{
"start": [3,0],
"objectives":
    {
    "G": [4, 13]
    },
"bridges": {},
"map":
["000001111110000",
"000001001110000",
"000001001111100",
"111111000001111",
"000011100001111",
"000011100000111",
"000000100110000",
"000000111110000",
"000000111110000",
"000000011100000"]
}

