{
    "start": [5,0],
    "objectives":
        {
        "G": [1, 2]
        },
    "bridges": 
        {},
    "map":
    ["011110000000",
    "011110000000",
    "011100000000",
    "010001111110",
    "010001100110",
    "111111100111",
    "000001000001",
    "000001111001",
    "000001111111",
    "000000001110"]
    }